###################################
#.................................#
#.................................#
#..#######...............#######..#
#..#.....#...............#.....#..#
#..#.....#...............#.....#..#
#..###.###...............###.###..#
#.................................#
#.................................#
#..###.###...............###.###..#
#..#.....#...............#.....#..#
#..#.....#...............#.....#..#
#..#######...............#######..#
#.................................#
#.................................#
###################################
###################################
###################################
###################################
###################################
###################################
###################################
###################################
###################################
###################################
###################################
###################################
###################################
###################################
###################################
###################################
###################################
###################################
###################################
###################################
